15
199
000000000000000000000000000000000000000000000000000000000000001111111111111111111111111111111111111111111111111111111111111111111111111111110000000000000000000000000000000000000000000000000000000w000
000000000000000000000000000000000000000000000000000000000000001111111111111111111111111111111111111111111111111111111111111111111111111111110000000000000000000000000000000000000000000000000000000w000
000000000000000000000000000000000000000000000000000000000000001111111111111111111111111111111111111111111111111111111111111111111111111111110000000000000000000000000000000000000000000000000000000w000
000000000000000000000000000000000000000000000000000000000000001111111111111111111111111111111111111111111111111111111111111111111111111111110000000000000000000000000000000000000000000000000000000w000
000000000000000000000000000000000000000000000000000000000000001111111111111111111111111111111111111111111111111111111111111111111111111111110000000000000000000000000000000000000000000000000000000w000
000000000000000000000000000000000000000000000000000000000000001111111111111111111111111111111111111111111111111111111111111111111111111111110000000000000000000000000000000000000000000000000000000w000
000000000000000000000000000000000000000000000000000000000000001111111111111111111111111111111111111111111111111111111111111111111111111111110000000000000000000000000000000000000000000000000000000w000
000000000000000000000000000000000000000000000000000000000000001111111111111111111111111111111100000000022111111111111111111111111111111111110000000000000000000000000000000000000000000000000000000w000
00000000000000000000000000000000000000000000kkkkkk00k0000000001111111111111111111111111111100000000000000000000000222222222222222222222222220000000000000000000000000000000000000000000000000000000w000
000000000000000000000000000211001100111111111111100000000000030000000000000022222200000000000000000000000000000000000000000000000000000000000000000000000000000000000000000000000000000000000000000w000
000000000000000000000000211111001100111111111111111100000000000000000000000000000000000000000021111100000000000000000000000000k000k000000000000000000000000a000000000000000000000000000000000000000w000
000000000000000000000211111111001100111111111111111111100000000000000000000000000000000000021111111100000000000000000000000000000000000000000000000000000001111111111110000000000000000000000000000w000
1111111111111111111111111111110011001111111111111111111111110011111111111100000000021111111111111111001100111111111111111111111111001111111100001110000011000000000000000000000000000001111111111111111
1111111111111111111111111111110011001111111111111111111111110011111111111111000021111111111111111111001100111111111111111111111111001111111101100000011000000000000000000000000000000001111111111111111
1111111111111111111111111111113311331111111111111111111111113311111111111111111111111111111111111111331133111111111111111111111111331111111133333333333333333333333333333333333333333331111111111111111