15
199
0000000000000000000000000000000000000000000000000000000000000000000000000000000000000000000000000000000000000000000000000000k000000000000000000000000000000k00000000000000k0000000k000000000k00000kW0k0
000000000000000000000000000000000000000000000000000000000000000000000000000000000000000000000000000000000000000000000000000000000000000000000000000000000000000000000000000000000000000000000000000W000
000000000000000000000000000000000000000000000000000000000000000000000000000000000000000000000000000000000000000000000000000000000000000000000000000000000000000000000000000000000000000000000000000W000
000000000000000000000000000000000000000000000000000000000000000000000000000000000000000000000000000000000000000000000000000000000000000000000000000000000000000000000000000000000000000000000000000W000
0000000000000000000000000000000000000000000000000000000000000k0000000000000000000000000000000000000000000000000000000000000000000000000000000000000000000000000000000000000000000000000000000000000W000
0000000000000000000000000000000000000000000000000000000000000000000000000000000000000000000000000000000000000000000000000000000000000000000000000000000000000000000000000000000000000000000021111111111
0000000000000000000000000000000000000000000000000000000000000000000000000000000000000000000000000000000000000000000000000000000000000000000000000000000000000000000000000000000000000000002111111111111
0000000000000000000000000000000000000000000000000000000000000000000000000000000000000000000000000000000000000000000000000000000000000000000000000000000000000000000000000000000211100111111111111111111
0000000000000000000000000000000000000000000000000000000000000000000000000000000000000000000000000000000000000000000000000000000000000000000000000000000000000000000000000000211111100111111111111111111
0000000000000000000000000000000000000000000000000000000000000000000000000000000000000000000000000000000000000000000000000000000000000000000000000000000000000000000000000211111111100111111111111111111
00000000000000000000k00000000000000000000000000000000000000000000000000000k000000000000000000021111100000000000000000000000000k000k00000000000000000000000000000000000211111111111100111111111111111111
0000000000000000000000000000000000000000002111100000000000000000000000000000000000000000000211111111000000000000000000000000000000000000211100000000000000000000000211111111111111100111111111111111111
1111111111111111111111111001110011001111111111100011111111110011111111111100000000021111111111111111001100111111100000000021111111001111111100011111111111111111111111111111111111100111111111111111111
1111111111111111111111111001110011001111111111100011111111110011111111111111000021111111111111111111001100111111111110011111111111001111111100011111111111111111111111111111111111100111111111111111111
1111111111111111111111111331113311331111111111133311111111113311111111111111111111111111111111111111331133111111111113311111111111331111111133311111111111111111111111111111111111133111111111111111111