15
199
000000000000000000000000000000000000000000000000000000000000000000000000000000000000000000k0000000000000000000000000k0000000k0000000000000000000000000000000000000k000000000000000k0000000000000000g000
000000000000000000000000000000000000000000000000000000000000000000000000000000000000000000000000000000000000000000000000000000000000000000000000000000000000000000000000000000000000000000000000000g000
0000000000000000000000000000000000000000000000000000000000000000000000000000000000000000000000000000000000000000000000000000000000000000000000000000000000000000000000000000a000000000000k000k00k00g000
00000000000000000000000000k000000000000000000000000000000000000000000000000000000000000000000000000000000000000000000000000000000000000000000000000000000000000000000000002111111000000000000000000g000
0000000000000000000000000000000000000000000000000000000000000k0000000000000000000000000000000000000000000000000000000000000000000000000000000000000000000000000000000021111111111000000000000000000g000
000000000000000000000000000000000000000000000000000000000000000000000000000000000000000000000000000000000000000000000000000000000000110000000000000000000000000000211111111111111000000000000000000g000
000000000000000000000000000000000000000000000000000000000000000000000000000000000000000000000000000000000000011111111111111001100110000000021111111002111111111111111111111111111000000000000000000g000
00000000000000000000000000000000000000000000000000000000000000000000000000000000000000000000000000000000000100000000000000k000000000000011000000000000000000000000000000k0000000000000k0000k0000000g000
000000000000000000000000000000000000000000000000000000000000000000000000000000000000000000000000000000001100000000000000000000000000000000000000000000000000000000000000000000000000000000000000000g000
000000000000000000000000000000000000000000000000000000000000000000000000000000000000000000000000000000100000000000000000000000000000000000000000000000000000000000000000000000000000000000000000000g000
000000000000000000000000000000k0000000000000000000000000000000000000000000k000000000000000000021111100000000000000000000000000k000k0000000000000000000000000000000000000000000000000000000000000000g000
00000000000000000000000000000000000000000000000k00kk000000000000000000000000000000000000000211111111000000000000000000000000000000000000211100000000000000000000000000k00000000k0000000000000000000g000
1111111111111111111111111111110011001111111111111111111111110011111111111100000000021111111111111111001100111111111111111111111111001111111100000021111111111111111111111111111111111111111111111111111
1111111111111111111111111111110011001111111111111111111111110011111111111111000021111111111111111111001100111111111111111111111111001111111100001000000000000000000000000000000000000001111111111111111
1111111111111111111111111111113311331111111111111111111111113311111111111111111111111111111111111111331133111111111111111111111111331111111133333333333333333333333333333333333333333331111111111111111
